Action=Åtgärd
AddRemoveSelectedUsers=Lägg till/ta bort valda användare
AddRevokeSysAdmin=Tilldela / återkalla SysAdmin
ADMConfig=D365FO Admin Toolkit-konfiguration
ADMDisableUsersJob=D365FO Admin Toolkit Exekvera Inaktiva Användare Jobb
ADMEntraIdGroupDynamicRoleAssignmentDeveloper=ADMEntraIdGroupDynamicsRoleAssignment tabellen innehåller information om automatisk rolltilldelning skall underhållas för rolltilldelning av Azure Entra ID säkerhetsgrupper
ADMEntraIdGroupSecurityRoleAssignmentRuleDeveloper=ADMENtraIdGroupDynamicsRoleAssignment tabellen innehåller information om vilka automatiska rolltilldelninger som skapats för vilka Azure Entra ID säkerhetsgrupper
ADMEntraIDGroupUserMembershipDeveloper=ADMEntraIdGroupUserMemebership innehåller information om Entra ID gruppmedlemskap per användare.
ADMEntraIdGroupUserView=Entra ID gruppmedlemskapsvy
ADMExportRoleAccess=D365FO Admin Toolkit Exportera rollåtkomst
ADMMaintain=D365FO Admin Toolkit Underhåll
ADMParametersDeveloper=ADMParameters tabellen innehåller grundläggande information för D365 Admin toolkit modulen.
ADMSysAdmAssignment=D365FO Admin Toolkit SysAdmin-tilldelning
ADMUserEntraIdGroup=New Text
ADMUserEntraIdGroupLastSync=Senaste synkroniseringen av Entra ID Grupper
ADMUserEntraIdGroupLastSyncDeveloper=ADMUserEntraIdGroupLastSync tablen innehåller information om när den senaste synkronisering gjordes av Azure Entra ID säkerhetsgrupper per användare.
ADMView=D365FO Admin Toolkit Visa
ADMViewDisabledUsersReport=D365FO Admin Toolkit Visa Inaktiva Användare Rapport
ADMViewReport=D365FO Admin Toolkit Visa SysAdmin-rapport
Assigned=Tilldelad
AssignmentReason=Tilldelningsorsak
AssingSysAdmin=Tilldela SysAdmin
ASTSysAdminChange=Admin Security Toolkit - SysAdmin-ändring
AutomaticRoleAssignment=Automatisk rolltilldelning
Cancel=Avbryt
ChangeReason=SysAdmin-tilldelning Ändra orsak:
ConfigurationSetup=Konfigurationsinställning
D365FOAdminToolkit=D365FO Admin Toolkit
DateTime=Datum Tid
DefaultNumDaysReport=Standardantal dagar för rapporter
DisableSysAdminBatchJobHelp=Inaktiverar utgångna SysAdmin-rolltilldelningar
DisableSysAdminBatchJobLabel=Inaktivera utgångna SysAdmin-rolltilldelningar
DisableUserJob=Inaktiva Användare Jobb
DisableUserNumDays=Inaktica Användare Antal Dagar
EmptyReason=Värde för orsak måste anges.
EndDate=Slutdatum:
EnvConfigFileGenerated=Konfigurationsfil för miljö genererades framgångsrikt.
Environment=Miljö
ExcludedUserList=Utesluten användarlista
ExcludedUsers=Uteslutna användare
ExportRoleAccess=Exportera rollåtkomst
ExportSysConfig=Exportera systemkonfiguration
General=Allmänt
InquiriesReports=Förfrågningar och rapporter
LastLogin=Senaste inloggning
ModifiedBy=Ändrad av
NumDaysLastLogin=Dagar sedan senaste inloggning :
Parameters=D365FO Admin Toolkit Parametrar
PeriodicTasks=Periodiska uppgifter
PopulateExcludedUserList=Fylld lista med uteslutna användare med tjänstkonton.
PopulateExcludedUsers=Fyll i uteslutna användare
Reason=Orsak
Revoked=Återkallad
RevokeSysAdmin=Återkalla SysAdmin
RoleAccessFileGenerated=Rollåtkomstfil genererades framgångsrikt.
SendTelemetrySysAdminLogHelp=Skickar telemetri till application insights när logg skapas i SysAdminLog
SendTelemetrySysAdminLogLabel=SysAdminLog
Setup=Inställning
ShowReasonDialog=Visa orsaksdialog för SysAdmin
ShowSysAdminExpiryDateDialog=Visa utgångsdatum för SysAdmin
StartDate=Startdatum:
Submit=Skicka
SysAdmin=Systemadministratör
SysAdminAssigned=Tilldelade SYSADMIN-rollen till %1
SysAdminAssignReport=SysAdmin-tilldelningsrapport
SysAdminExpiryDateDefaultHours=Standard antal timmar
SysAdminNotAssigned=SYSADMIN-rollen inte tilldelad till %1
SysAdminReport=SysAdmin-rapport
SysAdminRevoked=Tog bort SYSADMIN-rollen från %1
User=Användare
UserDisableMessage=Users disabled if they have not logged in for %1 days.
UserDisableReport=Inaktiva Användare Rapport
UserDisableTitle=Inaktivera User Process Complete
UserId=Användaridentifikation
UserList=Användarlista
UserName=Användarnamn
UsersForEntraIdGroup=Användare för Entra ID grupp
UsersForGroup=Användare för grupp
